E,1,1,1,1,1,1,1, ,1,
 , , , ,C, , , , ,1,
1,1,1, ,1,1,1,1,1, ,
 , ,1, ,1, , , , , ,
C, ,1, ,1,1, ,1,1,1,
 , , , ,1,C, , , , ,
 ,1,1,1,1, , ,1, ,C,
 ,1, , , , , , ,1,1,
 ,1,1,1,1,1,1, , ,1,
C, , , , , , , , ,1,